40
8
19 0 0 0 0 0 0 0 0 0 0 0 0 0 0 0 0 0 0 0 0 0 0 0 0 0 0 0 0 0 0 0 0 0 0 0 0 0 0 19
19 0 0 48 0 0 0 0 0 0 0 48 0 0 0 0 0 0 0 0 0 0 0 0 0 0 0 0 0 0 0 0 0 0 0 0 0 0 0 19
19 15 16 17 0 21 0 21 0 0 48 15 16 17 0 0 0 0 0 0 0 0 0 0 0 0 0 0 0 0 0 0 0 0 0 0 0 22 23 19
19 18 19 20 0 0 0 0 48 0 21 0 0 0 0 0 0 0 0 0 0 0 0 0 0 0 0 0 0 0 0 0 0 0 0 0 21 0 0 19
19 0 0 0 0 0 48 0 21 0 0 0 0 0 0 0 0 0 0 0 16 24 16 24 16 24 16 0 0 0 0 0 21 0 21 0 0 0 0 19
19 0 0 48 48 0 21 0 0 48 48 0 48 0 21 0 21 0 0 16 19 19 19 19 19 19 19 16 0 0 21 0 0 0 0 21 0 0 36 19
19 16 24 16 16 26 26 16 16 16 16 24 16 26 26 26 26 26 16 19 19 19 19 19 19 19 19 19 16 26 26 26 26 26 26 26 16 16 16 19
19 19 19 19 19 25 25 19 19 19 19 19 19 25 25 25 25 25 19 19 19 19 19 19 19 19 19 19 19 25 25 25 25 25 25 25 19 19 19 19