50
8
19 0 0 0 0 0 0 0 0 0 0 0 0 0 0 0 0 0 0 0 0 0 0 0 0 0 0 0 0 0 0 0 0 0 0 0 0 0 0 0 0 0 0 0 0 0 0 0 0 19
19 0 0 0 0 0 0 0 0 0 0 0 0 0 0 0 0 0 0 0 0 0 0 0 0 0 0 0 0 0 0 0 0 0 0 0 0 0 0 0 0 0 0 0 0 0 0 0 0 19
19 0 0 0 0 0 0 0 0 0 0 0 0 0 0 0 0 0 0 0 0 0 0 0 0 0 0 0 0 0 0 0 0 0 0 0 0 0 0 0 0 0 0 16 0 0 0 0 36 19
19 0 0 0 0 0 0 0 0 0 0 0 0 0 0 0 16 0 0 0 0 16 0 0 0 0 0 0 0 0 0 0 0 0 0 0 0 0 0 0 0 0 21 19 19 19 19 19 19 19
19 0 0 0 0 0 0 16 0 22 23 0 21 0 21 0 19 19 19 19 19 19 16 0 0 0 0 0 0 0 0 24 0 24 0 0 0 0 0 0 0 21 0 0 0 0 0 0 0 19
19 16 16 16 16 16 16 19 26 26 26 26 26 26 26 26 26 26 26 26 26 26 19 16 0 0 0 0 0 0 21 21 21 21 21 0 0 21 0 21 0 0 0 0 0 0 0 0 0 19
19 19 19 19 19 19 19 19 25 25 25 25 25 25 25 25 25 25 25 25 25 25 19 19 16 0 0 0 16 26 26 26 26 26 26 16 24 24 24 24 24 24 24 24 24 24 24 24 24 19
19 19 19 19 19 19 19 19 25 25 25 25 25 25 25 25 25 25 25 25 25 25 19 19 19 19 19 19 19 25 25 25 25 25 25 19 19 19 19 19 19 19 19 19 19 19 19 19 19 19