62
8
19 0 0 0 0 0 0 0 0 0 0 0 0 0 0 0 0 0 0 0 0 0 0 0 0 0 0 0 0 0 0 0 0 0 0 0 0 0 0 0 0 0 0 0 0 0 0 0 0 0 0 0 0 0 0 0 0 0 0 0 0 19
19 0 0 0 0 0 0 0 0 0 0 0 0 0 0 0 0 0 0 0 0 0 0 0 0 0 0 0 0 0 0 0 0 0 0 0 0 0 0 0 0 0 0 0 0 0 0 0 0 0 0 0 0 0 0 0 0 0 0 0 0 19
19 0 0 0 0 0 0 0 0 0 0 0 0 0 0 0 0 0 0 0 0 0 0 0 0 16 0 0 24 0 0 0 24 0 0 16 0 0 0 0 0 0 0 0 0 0 0 24 0 36 0 24 0 0 0 0 0 0 0 0 0 19
19 0 0 0 0 0 21 0 21 0 16 0 0 0 16 0 0 0 0 0 0 0 0 21 0 19 16 16 16 16 16 16 16 16 16 19 0 21 0 0 0 0 0 0 0 0 21 21 21 21 21 21 21 0 21 0 0 0 0 0 0 19
19 0 21 0 21 0 0 0 0 0 19 16 16 16 19 0 21 0 0 0 0 0 21 0 0 0 0 0 0 0 0 0 0 0 0 0 0 0 0 16 0 0 0 0 16 0 0 0 0 0 0 0 0 0 0 0 16 0 0 0 0 19
19 0 0 0 0 0 0 0 0 0 0 0 0 0 0 0 0 0 21 0 22 23 0 0 0 0 0 0 0 0 0 0 0 0 0 0 0 0 0 19 16 16 16 16 19 0 0 0 0 0 0 0 0 0 0 0 19 16 16 16 16 19
19 26 26 26 26 26 26 26 26 26 26 26 26 26 26 26 26 26 26 26 26 26 26 26 26 26 26 26 26 26 26 26 26 26 26 26 26 26 26 26 26 26 26 26 26 26 26 26 26 26 26 26 26 26 26 26 26 26 26 26 26 19
19 25 25 25 25 25 25 25 25 25 25 25 25 25 25 25 25 25 25 25 25 25 25 25 25 25 25 25 25 25 25 25 25 25 25 25 25 25 25 25 25 25 25 25 25 25 25 25 25 25 25 25 25 25 25 25 25 25 25 25 25 19